{
  "name": "Level 2 - Pyramid Full",
  "rows": 30,
  "cols": 42,
  "brick_width": 16,
  "brick_height": 12,
  "brick_gap": 1,
  "origin_x": 0,
  "origin_y": 120,
  "pattern": [
    "000000000000000000001100000000000000000000",
    "000000000000000000222222000000000000000000",
    "000000000000000011111111110000000000000000",
    "000000000000002222222222222200000000000000",
    "000000000000111111111111111111000000000000",
    "000000000022222222222222222222220000000000",
    "000000001111111111111111111111111100000000",
    "000000222222222222222222222222222222000000",
    "000011111111111111111111111111111111110000",
    "222222222222222222222222222222222222222222",
    "111111111111111111111111111111111111111111",
    "222222222222222222222222222222222222222222",
    "111111111111111111111111111111111111111111",
    "222222222222222222222222222222222222222222",
    "111111111111111111111111111111111111111111",
    "222222222222222222222222222222222222222222",
    "111111111111111111111111111111111111111111",
    "222222222222222222222222222222222222222222",
    "111111111111111111111111111111111111111111",
    "222222222222222222222222222222222222222222",
    "111111111111111111111111111111111111111111",
    "222222222222222222222222222222222222222222",
    "111111111111111111111111111111111111111111",
    "222222222222222222222222222222222222222222",
    "111111111111111111111111111111111111111111",
    "222222222222222222222222222222222222222222",
    "111111111111111111111111111111111111111111",
    "222222222222222222222222222222222222222222",
    "111111111111111111111111111111111111111111",
    "222222222222222222222222222222222222222222"
  ]
}