{
  "name": "Level 2 - Pyramid Full",
  "rows": 30,
  "cols": 40,
  "brick_width": 16,
  "brick_height": 12,
  "brick_gap": 0,
  "origin_x": 40,
  "origin_y": 120,
  "pattern": [
    "0000000000000000000220000000000000000000",
    "0000000000000000001111000000000000000000",
    "0000000000000000022222200000000000000000",
    "0000000000000000111111110000000000000000",
    "0000000000000002222222222000000000000000",
    "0000000000000011111111111100000000000000",
    "0000000000000222222222222220000000000000",
    "0000000000001111111111111111000000000000",
    "0000000000022222222222222222200000000000",
    "2222222222222222222222222222222222222222",
    "1111111111111111111111111111111111111111",
    "2222222222222222222222222222222222222222",
    "1111111111111111111111111111111111111111",
    "2222222222222222222222222222222222222222",
    "1111111111111111111111111111111111111111",
    "2222222222222222222222222222222222222222",
    "1111111111111111111111111111111111111111",
    "2222222222222222222222222222222222222222",
    "1111111111111111111111111111111111111111",
    "2222222222222222222222222222222222222222",
    "1111111111111111111111111111111111111111",
    "2222222222222222222222222222222222222222",
    "1111111111111111111111111111111111111111",
    "2222222222222222222222222222222222222222",
    "1111111111111111111111111111111111111111",
    "2222222222222222222222222222222222222222",
    "1111111111111111111111111111111111111111",
    "2222222222222222222222222222222222222222",
    "1111111111111111111111111111111111111111",
    "2222222222222222222222222222222222222222"
  ]
}